{
  "a": "あ",
  "i": "い",
  "u": "う",
  "e": "え",
  "o": "お",

  "s": "い",
  "sh": "い",
  "x": "え",
  "n": "あ",

  "k": "あ",
  "g": "あ",
  "t": "う",
  "ch": "い",
  "z": "い",

  "m": "う",
  "h": "あ",
  "f": "う",
  "p": "う",

  "_fallback": "あ"
}
