{
  "a": "あ",
  "i": "い",
  "u": "う",
  "e": "え",
  "o": "お",
  "s": "い",
  "tsu": "う",
  "n": "ん",
  "_fallback": "あ"
}
